BBBTBBBBBBBBBBBBBBB
B........B........B
BoBB.BBB.B.BBB.BBoB
B.................B
B.BB.B.BBBBB.B.BB.B
B....B...B...B....B
BBBB.BBB B BBB.BBBB
BBBB.B       B.BBBB
BBBB.B BBbBB B.BBBB
T   .  BpicB  .   T
BBBB.B BBBBB B.BBBB
BBBB.B   +   B.BBBB
BBBB.B BBBBB B.BBBB
B........B........B
B.BB.BBB.B.BBB.BB.B
B..B.....P.....B..B
BB.B.B.BBBBB.B.B.BB
B....B...B...B....B
BoBBBBBB.B.BBBBBBoB
B.................B
BBBBBBBBBBBBBBBTBBB