BBBBBBBBBBBBBBBBBBB
B........B........B
B.BB.BBB.B.BBB.BB.B
B.................B
B.BB.B.BBBBB.B.BB.B
B....B...B...B....B
BBBB.BBB B BBB.BBBB
   B.B       B.B
BBBB.B B   B B.BBBB
    .  B   B  .
BBBB.B BBBBB B.BBBB
   B.B       B.B
BBBB.B BBBBB B.BBBB
B........B........B
B.BB.BBB.B.BBB.BB.B
B..B.....P.....B..B
BB.B.B.BBBBB.B.B.BB
B....B...B...B....B
B.BBBBBB.B.BBBBBB.B
B.................B
BBBBBBBBBBBBBBBBBBB